8888888888888888888
8000088000000000008
8000088000000000008
8000080000000088888
8000000000000000008
8000000000000000008
8880000000000000008
8880000000000000008
8000000000000000008
8000080000000088888
8008880000000000008
8008000000000000008
8008800000000000008
8000800000000000088
8000800000000000888
8008800000000000888
9008000000000000888
8008008008000008888
8888888888888888888