88888888888888888888
80000000000000000008
80000000000000000008
88888888880000008888
80000000080000000008
80000000080000000008
80000000080000000008
80000000080008880008
80080000080008880088
80080000080008880008
80080000088008880008
88880000080000800008
80000000000000000008
80000080000000000008
80000080000000000008
80000080000000000008
88888888888800000008
80000000000000000008
80000000000000000008
88888898888888888888