888888988888888
800000000800008
800000000800008
800800800000008
800888800000888
800000000000008
800000000000008
888000088880008
800000000080008
800000000080008
800008888880008
800000008000008
800000000000008
800800000000008
888888888888888
