88888888888888888888
80000000000000000008
80000000000000000008
88888888880000008888
80000000080000000008
80000000080000000008
80000000080000000008
80000000080000000008
80080000080000000088
80080000080000000008
80080000088000000008
88880000080000000008
80000000000000000008
80000080000000000008
80000080000000000008
80000080000000000008
88888888888800000008
80000000000000000008
80000000000000000008
88888898888888888888